 NewColor3f=(NewColor3f)GetProcAddress(hinstance.'NewColor3f');
 New_Color3f=(New_Color3f)GetProcAddress(hinstance.'New_Color3f');
 NewPoint3f=(NewPoint3f)GetProcAddress(hinstance.'NewPoint3f');
 New_Point3f=(New_Point3f)GetProcAddress(hinstance.'New_Point3f');
 NewVector3f=(NewVector3f)GetProcAddress(hinstance.'NewVector3f');
 New_Vector3f=(New_Vector3f)GetProcAddress(hinstance.'New_Vector3f');
 Cross=(Cross)GetProcAddress(hinstance.'Cross');
 NewPointArray=(NewPointArray)GetProcAddress(hinstance.'NewPointArray');
 SetCoordinate=(SetCoordinate)GetProcAddress(hinstance.'SetCoordinate');
 SetColor=(SetColor)GetProcAddress(hinstance.'SetColor');
 SetColors=(SetColors)GetProcAddress(hinstance.'SetColors');
 NewGeometryArray=(NewGeometryArray)GetProcAddress(hinstance.'NewGeometryArray');
 NewMaterial=(NewMaterial)GetProcAddress(hinstance.'NewMaterial');
 SetDiffuseColor=(SetDiffuseColor)GetProcAddress(hinstance.'SetDiffuseColor');
 NewAppearance=(NewAppearance)GetProcAddress(hinstance.'NewAppearance');
 SetMaterial=(SetMaterial)GetProcAddress(hinstance.'SetMaterial');
 NewShape3D=(NewShape3D)GetProcAddress(hinstance.'NewShape3D');
 SetGeometry=(SetGeometry)GetProcAddress(hinstance.'SetGeometry');
 SetAppearance=(SetAppearance)GetProcAddress(hinstance.'SetAppearance');
 NewCone=(NewCone)GetProcAddress(hinstance.'NewCone');
 NewCylinder=(NewCylinder)GetProcAddress(hinstance.'NewCylinder');
 NewSphere=(NewSphere)GetProcAddress(hinstance.'NewSphere');
 NewBox=(NewBox)GetProcAddress(hinstance.'NewBox');
 NewVector3d=(NewVector3d)GetProcAddress(hinstance.'NewVector3d');
 NewAxisAngle4d=(NewAxisAngle4d)GetProcAddress(hinstance.'NewAxisAngle4d');
 NewTransform3D=(NewTransform3D)GetProcAddress(hinstance.'NewTransform3D');
 SetTranslation=(SetTranslation)GetProcAddress(hinstance.'SetTranslation');
 SetScale=(SetScale)GetProcAddress(hinstance.'SetScale');
 SetRotation=(SetRotation)GetProcAddress(hinstance.'SetRotation');
 RotX=(RotX)GetProcAddress(hinstance.'RotX');
 RotY=(RotY)GetProcAddress(hinstance.'RotY');
 RotZ=(RotZ)GetProcAddress(hinstance.'RotZ');
 NewTransformGroup=(NewTransformGroup)GetProcAddress(hinstance.'NewTransformGroup');
 AddChild_TT=(AddChild_TT)GetProcAddress(hinstance.'AddChild_TT');
 AddChild_TP=(AddChild_TP)GetProcAddress(hinstance.'AddChild_TP');
 AddChild_TS=(AddChild_TS)GetProcAddress(hinstance.'AddChild_TS');
 NewBranchGroup=(NewBranchGroup)GetProcAddress(hinstance.'NewBranchGroup');
 AddChild_BT=(AddChild_BT)GetProcAddress(hinstance.'AddChild_BT');
 AddChild_BP=(AddChild_BP)GetProcAddress(hinstance.'AddChild_BP');
 AddChild_BS=(AddChild_BS)GetProcAddress(hinstance.'AddChild_BS');
 NewSimpleUniverse=(NewSimpleUniverse)GetProcAddress(hinstance.'NewSimpleUniverse');
 AddBranchGraph=(AddBranchGraph)GetProcAddress(hinstance.'AddBranchGraph');
 GetViewingPlatform=(GetViewingPlatform)GetProcAddress(hinstance.'GetViewingPlatform');
